 1111111111 111111111
10P10000011 1000000101
1001000010010C00000E01
1001001001111111111001
10000010100C1000000011
100C0010000110000C0111111
1111111111111111111111