1111111111111111111111
10010000010E0000000001
1001000010000C00000E01
1001001001111111111001
10000010000C0000000001
100C0010000000P0000C01
1111111111111111111111
