1111111111111111111111111111111
1P00100000001000001010000010001
1110111110101011111011101011101
1000100000101000100010001000101
1011111011111110101011111011101
1000101000001010001010000010001
1010101111101010111110111011101
1010001000000010000000001000001
1011101010111110111110111111101
1010000010000010100010101000001
1010111110101110111011101111111
1010000010101000100010000000001
1010101111101110111010111110101
10101000100000C0000000000010101
1010101111101111101111101010111
1110100000101110111011101011111
1000101010100010000000001010001
1011111110101010101010101010101
10000010100000000000101000001E1
1111111111111111111111111111111
