111
1001
10001
10000111
1CPE111
1111